........................................#############..
........................................#...........#..
........#######.........................#...........#..
........#.....#.........................#...........#..
........#.....#.#############...........#...........#..
........#.....#.#...........#...........#...........#..
........#.....#.#...........#...........#...........#..
........#.....#.#...........#...........#...........#..
........#############.......#...........#...........#..
..............#.#...#.......#...........#...........#..
..............#.#.###########.....#######...........#..
..............#.#.#.#.............#.................#..
..............###########.........#.......###########..
................#.#.#...#.........#.......#............
................#.#.#...#.........#.......#............
................#.#.#...#.........#.......#............
................##########^.......#.......#............
..................#.#...#.........#.......#............
..........###########...#.........#.......#............
..........#.......#.....#.........#.......#............
..........#.......###########.....#.......#............
..........#.............#...#.....#.......#............
......###########.......###########.......#############
......#...#.....#...........#.........................#
......#...#.....#...........#.........................#
......#...#.....#...........#.........................#
......#...#.....#...........#.........................#
......#...#.....#...........#.........................#
###########.....#...........#.........................#
#.....#.........#...........#..........................
#.....#.........#...........#..........................
#.....#.........#...........#..........................
#.....#.........#############..........................
#.....#................................................
#######................................................


